00 00 00 00 00 00 00 00 00 00 00 00 00 00 00 00 00 00 00 00 00 00 00 00
00 06 06 06 06 06 06 06 06 00 00 00 00 00 00 00 00 00 00 00 00 00 00 00
00 06 06 06 06 06 06 06 06 00 00 00 00 00 00 00 00 00 00 00 00 00 00 00
00 06 06 06 06 06 06 06 06 00 00 00 00 00 00 00 00 00 00 08 01 01 08 00
00 06 06 06 09 09 06 06 06 00 00 00 00 00 00 00 00 00 00 08 01 01 08 00
00 01 01 01 07 07 01 01 01 01 01 01 01 01 01 01 01 01 01 01 07 07 01 00
00 01 01 01 07 07 07 07 07 07 07 07 07 07 07 07 07 07 07 07 07 07 01 00
00 01 01 01 07 07 07 07 07 07 07 07 07 07 07 07 07 07 07 07 07 07 01 00
00 01 01 01 01 01 01 01 01 01 01 07 07 01 01 01 01 01 01 01 01 01 01 00
00 01 01 01 01 01 01 01 01 01 01 07 07 01 01 01 01 01 01 01 01 01 01 00
00 01 01 01 01 01 01 01 01 01 01 07 07 01 01 01 01 01 01 01 01 01 01 00
00 01 01 01 01 01 01 01 01 01 01 07 07 01 01 01 01 01 01 01 01 01 01 00
00 00 00 00 00 00 00 00 00 00 02 02 02 02 00 00 00 00 00 00 00 00 00 00
00 00 00 00 00 00 00 00 00 00 00 00 00 00 00 00 00 00 00 00 00 00 00 00