00 00 00 00 00 00 00 00 02 02 02 02 02 02 02 02 02 02 02 02 02 02 02 02
00 02 02 02 02 02 02 00 02 02 02 02 02 02 02 02 02 02 02 02 02 02 02 02
00 02 02 02 02 02 02 00 02 02 02 02 02 02 02 02 02 02 02 02 02 02 02 02
00 02 02 02 02 02 02 00 02 02 02 02 02 02 02 02 02 02 02 02 02 02 02 02
00 02 02 02 02 02 02 00 02 02 02 02 02 02 02 02 02 02 02 02 02 02 02 02
00 02 02 09 09 02 02 00 02 02 02 02 02 02 02 02 02 02 02 02 02 02 02 02
00 02 02 02 02 02 02 00 02 02 02 02 02 02 02 02 02 02 02 02 02 02 02 02
00 02 02 02 02 02 02 00 02 02 02 02 02 02 02 02 02 02 02 02 02 02 02 02
00 02 02 02 02 02 02 00 02 02 02 02 02 02 02 02 02 02 02 02 02 02 02 02
00 02 02 02 02 02 02 00 02 02 02 02 02 02 02 02 02 02 02 02 02 02 02 02
00 02 02 02 02 02 02 00 02 02 02 02 02 02 02 02 02 02 02 02 02 02 02 02
00 02 02 02 02 02 02 00 02 02 02 02 02 02 02 02 02 02 02 02 02 02 02 02
00 02 02 02 02 02 02 00 02 02 02 02 02 02 02 02 02 02 02 02 02 02 02 02
00 00 00 00 00 00 00 00 00 00 00 00 02 02 02 02 02 02 02 02 02 02 02 02